1111111111
1P00000001
1000000001
1000000001
1000000C01
1000000001
100C000001
1000000011
1000E00001
1111111111
