111111
100P11
1CE001
100CE1
111111