1111111111111111111111
1010001011101110101111
1010101111111111111011
1000000P00000000001111
1011101011101010111011
1111111011101010001011
1000111011111010111011
1010101011111110101011
1110111010001010111011
1000C00C101010000000E1
1111111110101111011111
1111101101101111011111
1010001011101110001111
101010C111111101011011
1000000000000000011111
1011101011111010111011
1111111011101010001011
1000111011111010111011
101010101111111C101011
1111111111111111111111