11111111
10C00P01
100E0001
1C000111
11111111

