1111111111111111111111
1010001011101110101111
1010101110000111111011
1000000000000000001111
1011101011101010111011
11111110111P1010001011
1000111010011010111011
1010101011111110101011
1110111010001010111011
1000C00C101010000C00E1
1111111110101111011101
1111101101101111011101
1010001011101110001101
101010C110011101011001
10000000000000C0011101
1011101011111010111001
1111111011101010001001
1000111000011010111011
101010101000011C101011
1111111111111111111111